try on - примерить
I'd like to try on this dress

find time for - находить время на

find time for all this - находить время на все

sure about - уверен по поводу
I'm not sure about it

wait for - ждать чего-то

cost more - стоить дороже

arrive at
arrive at the airport
arrive at the meeting

arrive in 

have breakfast - завтракать
have lunch - обедать
have dinner - ужинать

have a break - перерыв

talk on the phone
говорить по телефону

ran away - бежать от
They ran away from the police

at first - сначала
I din't like it at first

in the beginning - в начале
I didn't like this idea in the beginning

to be late for - опаздывать на

have to say that - должен сказать что

for a start - для начала

as for me - что касается меня

I expect - я ожидаю

one day - однажды

I suppose - я предполагаю

save up - накопить

do my best - сделать все возможное

move to - переезжать
He moved to another city

paid for ... by ... 
I paid for it by credit card

talk on the phone

pay attention to - обращать внимание на
I never pay attention to it

some times a week - несколько раз в неделю
I go there three times a week

the importance of - важность чего-то
We understand the importance of this thing

all understand - все понимать
We all understand it now

in front of - перед кем-то
I see a house in front of me now

take proper measures - принять надлежащие меры
As I know, they have already taken proper measures

I've always wanted to - я всегда хотел

To be honest - если честно

get a call from - перезвонили

fall asleep - заснуть

to tell the truth - сказать правду

with impatience - с нетерпением

rain so heavily - пошел такой сильный дождь

money to live on - деньги на которые жить

money for a living - денег на жизнь

get out of control - выходить из под контроля

by the time - к тому времени

tell someone a lie - сказать кому-то неправду

take off - взлетать
When he arrived at the airport, the plane had already taken off

land - приземляться
When he arrived at the airport, the plane hadn't landed yet

live up - оправдывать
He said that the performance hadn't lived up to his expectations

