You'll get tired soon - ты устанешь
think it over - обдумывать
save money - сэкономим деньги
get married - пожениться
It'll surprise you greatly - это удивит тебя сильно
It'll happen sooner or later - это произойдет рано или поздно
It'll depend on some other factors
reinvent the wheel - изобретать заного колесо
hurry up - торопиться
lend someone - отдолжить кому-либо
sum of money - сумма денег
regret something - пожалеть о чем либо
more than enough - более чем достаточно
teach someone a lesson - преподать кому-либо урок
apologize for something - извиняться за что-либо
be shocked - быть шокированым
borrow something - занять что-либо
solution to .. - решение чего-либо
lead to .. - приводить к 
take part in - принимать участие
react to - реагировать на
insist on .. - настаивать на
in one day - за один день
laugh at - смеяться над
the only right/correct - единственный верный
explain smt to - объяснять что-то кому-либо
point at - указывать на
last for - длитьться сколько-то but last forever - длиться вечно
last for about - длиться около
last for more than - более чем

the day after tomorrow - послезавтра
at the end of - в конце чего либо
Will it be possible at the beginning/end of the meeting

tomorrow morning/evening - к завтрашнему утру вечеру

get dark - темнеть
look (it/this word) up in a dictionary - посмотреть в справочнике
but 
look at (me/this slide/ ...) 

at last - наконец
Will the boy pass this exam at last

I'll be able to do it
Я смогу сделать это

I'll manage - я сумею
I'll be able - я смогу

start doing smt - начать что-либо делать
continue doing smt - продолжить что-либо делать

take place - проходить
Where will the conference take place

be able to do something - суметь что-либо сделать
be able to manage something - сумеет решить что-либо
How will the student be able to solve this problem

on a regular basis - на регулярной основе
What channels will your friend watch on a regular basis